Dein Foto zeigt einen zweiachsigen gedeckten GÃ¼terwagen in rotbrauner Farbgebung mit DB-Logo â€“ ein typischer Vertreter der Nachkriegszeit, vermutlich Bauart Gms 54 oder Gmms 60.

ğŸš‚ Vorbildinformationen
Merkmal	Beschreibung
Bauart (Vorbild)	Gedeckter GÃ¼terwagen Gms 54 (spÃ¤ter Gmms 60 / Gbs 245)
Bahngesellschaft	Deutsche Bundesbahn (DB)
Epoche	III â€“ IV (ca. 1954 â€“ 1975)
Bauart	Geschlossener Wagen mit Tonnendach und SchiebetÃ¼ren
Achsanzahl	2
Baujahre (Vorbild)	ca. 1953 â€“ 1958
LÃ¤nge Ã¼ber Puffer (Vorbild)	ca. 10,6 m
Ladegewicht	ca. 15 t
Verwendung	StÃ¼ckgutverkehr, Transport empfindlicher Waren (Maschinen, MÃ¶bel, Post, Lebensmittel)
Farbgebung	RAL 8012 Rotbraun mit hellgrauem oder beigem Dach
Besonderheiten	SchweiÃŸkonstruktion, leichte Stahlbauweise, allgegenwÃ¤rtig im DB-GÃ¼terverkehr

Die Gms 54-Serie bildete das RÃ¼ckgrat des GÃ¼terverkehrs in der Nachkriegszeit. Sie war auf fast allen deutschen und europÃ¤ischen Haupt- und Nebenstrecken zu sehen â€“ ein echter â€Brot-und-Butterâ€œ-Wagen der Bundesbahn.

ğŸ§© Zum Modell (Modellbahn)
Merkmal	Beschreibung
MaÃŸstab	H0 (1:87)
Farbgebung	DB-Rotbraun mit weiÃŸem DB-Keks und hellem Dach
Bauart	KunststoffgehÃ¤use mit Tonnendach, SchiebetÃ¼ren, feine Gravuren
Kupplung	NEM 362 mit Kurzkupplungskulisse
Hersteller (vermutlich)	Roco, Fleischmann oder MÃ¤rklin (alle haben diese DB-Gms-Modelle hergestellt)
Artikelnummern (Beispiele)	Roco 4335, Fleischmann 5071, MÃ¤rklin 4411
Epoche (Modell)	III
Material	Kunststoff mit Metallachsen
Besonderheiten	Vorbildgerechte Bedruckung, exakte Proportionen, feines Fahrwerk
ğŸ§¾ Kurzbeschreibung (fÃ¼r Homepage oder Sammlung)

DB Gedeckter GÃ¼terwagen Gms 54 â€“ Epoche III
Vorbildgerechtes Modell eines zweiachsigen gedeckten GÃ¼terwagens der Deutschen Bundesbahn in rotbrauner Lackierung.
Diese Wagenserie wurde ab Mitte der 1950er Jahre im StÃ¼ckgutverkehr eingesetzt und war auf nahezu allen Strecken in Deutschland anzutreffen.
Das H0-Modell Ã¼berzeugt durch detailreiche Gravuren, authentische Bedruckung und das charakteristische Tonnendach der DB-GÃ¼terwagen der Nachkriegszeit.