Auf deinem Foto sieht man eindeutig einen gedeckten GÃ¼terwagen der Deutschen Bundesbahn (DB) in brauner Farbgebung mit typischer Beschriftung und genieteten SeitenwÃ¤nden.

ğŸš‚ Vorbildinformationen
Merkmal	Beschreibung
Bauart (Vorbild)	Gedeckter GÃ¼terwagen Gms 54 (spÃ¤tere Bezeichnung: Gbs 254 / Glms)
Bahngesellschaft	Deutsche Bundesbahn (DB)
Epoche	III (ca. 1949 â€“ 1970)
Bauart	Zweiachsiger, geschlossener Wagen mit SchiebetÃ¼ren und Tonnendach
Baujahre (Vorbild)	ca. 1953 â€“ 1958
LÃ¤nge Ã¼ber Puffer (Vorbild)	ca. 10,6 m
Ladegewicht	bis ca. 15 t
HÃ¶chstgeschwindigkeit	90 km/h
Verwendung	Transport von witterungsempfindlicher Fracht (Kisten, MÃ¶bel, Lebensmittel, Post, Maschinen)
Lackierung	RAL 8012 â€“ Rotbraun (Standardfarbe der DB fÃ¼r GÃ¼terwagen)

Diese Wagen bildeten jahrzehntelang das RÃ¼ckgrat des StÃ¼ckgutverkehrs der DB. Sie waren universell einsetzbar und in groÃŸen StÃ¼ckzahlen gebaut â€“ spÃ¤ter vielfach modernisiert oder zu Spezialwagen umgebaut.

ğŸ§© Zum Modell (Modellbahn)
Merkmal	Beschreibung
MaÃŸstab	H0 (1:87)
Farbgebung	DB-Rotbraun mit weiÃŸer Beschriftung
Bauart	KunststoffgehÃ¤use mit feiner Gravur, Tonnendach, SchiebetÃ¼ren
Hersteller (vermutlich)	Fleischmann oder Roco (beide haben diese Wagenvariante sehr exakt umgesetzt)
Artikelnummern (Beispiele)	Fleischmann 5071, Roco 4335, MÃ¤rklin 4411
Kupplung	NEM 362 mit Kurzkupplungskulisse
Epoche (Modell)	III
Besonderheiten	Feine Beschriftung, DB-Keks-Logo, typische Nachkriegs-Baureihe
ğŸ§¾ Kurzbeschreibung (fÃ¼r Homepage oder Sammlung)

DB Gedeckter GÃ¼terwagen Gms 54 â€“ Epoche III
Vorbildgerechtes Modell eines klassischen zweiachsigen GÃ¼terwagens der Deutschen Bundesbahn in rotbrauner Lackierung. Diese Wagen wurden ab den 1950er Jahren fÃ¼r den Transport empfindlicher GÃ¼ter eingesetzt und waren auf nahezu allen Strecken in Deutschland anzutreffen.
Das H0-Modell Ã¼berzeugt durch fein detaillierte Gravuren, authentische Beschriftung und ein vorbildgetreues Tonnendach â€“ ein unverzichtbarer Bestandteil jeder Epoche-III-GÃ¼terzugkomposition.