Sehr gern ğŸ˜Š â€” du hast hier wieder ein wunderschÃ¶n erhaltenes Exemplar eines gedeckten GÃ¼terwagens der Deutschen Bundesbahn (DB), Epoche IIIâ€“IV, in der typischen rotbraunen Farbgebung mit Tonnendach. Der Wagen trÃ¤gt die Wagennummer 556 699 6, was ihn eindeutig als Vertreter der Baureihe Gms 54 kennzeichnet.

ğŸš‚ Vorbildinformationen
Merkmal	Beschreibung
Bauart (Vorbild)	Gedeckter GÃ¼terwagen Gms 54 (spÃ¤ter Gmms 60 / Gbs 245)
Bahngesellschaft	Deutsche Bundesbahn (DB)
Epoche	III â€“ IV (1954 â€“ 1975)
Baujahre (Vorbild)	Ab 1953
Achsanzahl	2
LÃ¤nge Ã¼ber Puffer	Ca. 10,6 m
Ladegewicht	Etwa 15 t
Laderaum	45 mÂ³
Farbgebung	RAL 8012 â€“ Rotbraun mit beigem oder grauem Dach
Verwendung	Transport empfindlicher GÃ¼ter (z. B. Maschinen, Lebensmittel, MÃ¶bel, Kistenware)
Besonderheiten	Tonnendach, beidseitige SchiebetÃ¼ren, geschweiÃŸte Stahlbauweise, isolierte AusfÃ¼hrung mÃ¶glich

Die Wagen der Gms-Reihe wurden in groÃŸer StÃ¼ckzahl gebaut und waren jahrzehntelang im europÃ¤ischen StÃ¼ckgutverkehr im Einsatz. Sie prÃ¤gten das Bild der Nachkriegs- und Wirtschaftswunderzeit auf deutschen Gleisen.

ğŸ§© Zum Modell (Modellbahn)
Merkmal	Beschreibung
MaÃŸstab	H0 (1:87)
Farbgebung	DB-Rotbraun mit weiÃŸem DB-Logo und exakten Anschriften
Bauart	KunststoffgehÃ¤use mit Tonnendach und SchiebetÃ¼ren
Kupplung	NEM 362 mit Kurzkupplungskulisse
Hersteller (vermutlich)	Roco, Fleischmann, MÃ¤rklin oder Trix
Artikelnummern (Beispiele)	Roco 4335, Fleischmann 5071, MÃ¤rklin 4411
Epoche (Modell)	III / IV
Material	KunststoffgehÃ¤use mit Metallachsen
Besonderheiten	Feine Gravuren, originalgetreue Beschriftung, vorbildgerechte Proportionen
ğŸ§¾ Kurzbeschreibung (fÃ¼r Homepage oder Sammlung)

DB Gedeckter GÃ¼terwagen Gms 54 â€“ Epoche III/IV
Hochdetailliertes H0-Modell eines zweiachsigen gedeckten GÃ¼terwagens der Deutschen Bundesbahn in klassischer rotbrauner Lackierung mit Tonnendach.
Diese Wagenserie wurde ab den 1950er Jahren im StÃ¼ckgutverkehr eingesetzt und war auf allen deutschen und europÃ¤ischen Strecken anzutreffen.
Das Modell besticht durch feine Gravuren, prÃ¤zise Beschriftung und eine vorbildgerechte Farbgebung â€“ ein authentisches SammlerstÃ¼ck fÃ¼r Freunde der DB-Epoche III.