Auf deinem Foto erkennt man ein hellgraues Modell eines gedeckten GÃ¼terwagens mit einem SBB-Logo (Schweizerische Bundesbahnen) auf der rechten Seite.

ğŸš‚ Vorbildinformationen
Merkmal	Beschreibung
Wagentyp (Vorbild)	Gedeckter GÃ¼terwagen, vermutlich Typ Gbs / Hbils / Hbis
Bahngesellschaft	SBB â€“ Schweizerische Bundesbahnen
Einsatzgebiet	GÃ¼terverkehr (StÃ¼ckgut, empfindliche oder witterungsgeschÃ¼tzte Fracht)
Epoche	IV â€“ V (ca. 1970 â€“ 2000)
Bauart	Geschlossener Wagenkasten aus Stahlblech mit seitlichen SchiebetÃ¼ren
Achszahl	2 (Zweiachser)
Bremse	Druckluftbremse (Knorr oder Westinghouse-System)
HÃ¶chstgeschwindigkeit (Vorbild)	100 km/h
Farbgebung	Hellgrau â€“ bei der SBB typisch fÃ¼r modernisierte Wagen ab den 1970er Jahren
Vorbildbezeichnung (mÃ¶gliche Varianten)	Hbis-vy, Hbils-vy oder Gbs-v â€“ je nach AusfÃ¼hrung der TÃ¼ren und LÃ¼ftungsgitter

Diese Wagen wurden europaweit im kombinierten GÃ¼terverkehr eingesetzt, besonders fÃ¼r Paletten-, Maschinen- und KonsumgÃ¼tertransporte.

ğŸ§© Zum Modell (Modellbahn)
Merkmal	Beschreibung
MaÃŸstab	H0 (1:87)
Farbgebung	SBB-Grau mit altem SBB-Logo (weiÃŸes Kreuz in Rhombusform)
Bauart	KunststoffgehÃ¤use, fein gravierte SchiebetÃ¼ren, Metallachsen
Hersteller (vermutlich)	Roco oder Fleischmann (beide haben nahezu identische Modelle dieser Bauart produziert)
Artikelnummern (Beispiele)	Roco 46212, Fleischmann 5234 oder Ã¤hnliche Serien
Kupplung	Normschacht NEM 362 mit Kurzkupplungskulisse
Epoche (Modell)	IV / V (zeitlich passend zu 1970â€“2000)
ğŸ§¾ Kurzbeschreibung (fÃ¼r Homepage oder Sammlung)

SBB gedeckter GÃ¼terwagen (Typ Gbs / Hbis, Epoche IVâ€“V)
Vorbildgerechtes Modell eines Schweizer GÃ¼terwagens der SBB in hellgrauer Farbgebung mit klassischem SBB-Logo. Der Wagen diente zum Transport empfindlicher GÃ¼ter im internationalen Verkehr.
Das H0-Modell Ã¼berzeugt durch prÃ¤zise Gravuren, maÃŸstÃ¤bliche Proportionen und saubere Beschriftung. Ideal geeignet fÃ¼r Epoche-IV/V-Anlagen mit modernem GÃ¼terverkehrsbestand.