Sehr schÃ¶n ğŸ˜Š â€“ das Modell auf deinem Foto ist wieder ein klassischer gedeckter GÃ¼terwagen der Deutschen Bundesbahn (DB), in rotbrauner Farbgebung mit beigem Dach, Beschriftung der Epoche III (ca. 1955â€“1970). Es handelt sich mit sehr hoher Wahrscheinlichkeit um einen Wagen der Bauart Gms 54 (spÃ¤ter Gmms 60).

ğŸš‚ Vorbildinformationen
Merkmal	Beschreibung
Bauart (Vorbild)	Gedeckter GÃ¼terwagen Gms 54 â€“ spÃ¤ter als Gmms 60 bezeichnet
Bahngesellschaft	Deutsche Bundesbahn (DB)
Epoche	III â€“ IV (ca. 1954 â€“ 1975)
Achsanzahl	2
Baujahre (Vorbild)	ab 1953
LÃ¤nge Ã¼ber Puffer (Vorbild)	10,6 m
Ladegewicht	ca. 15 t
Laderaum	45 mÂ³
Verwendung	Transport empfindlicher GÃ¼ter wie Maschinen, MÃ¶bel, Lebensmittel, Kistenwaren oder StÃ¼ckgut
Farbgebung	Rotbraun (RAL 8012) mit beigem oder grauem Dach
Besonderheiten	GeschweiÃŸte Bauweise, beidseitige SchiebetÃ¼ren, Tonnendach; einer der meistgebauten DB-GÃ¼terwagen der Nachkriegszeit

Die Gms 54-Wagen bildeten das RÃ¼ckgrat des DB-StÃ¼ckgutverkehrs. Ihre robuste Konstruktion und das mittlere Ladevolumen machten sie universell einsetzbar â€“ von NahgÃ¼terzÃ¼gen bis zu internationalen ZÃ¼gen im Binnen- und Exportverkehr.

ğŸ§© Zum Modell (Modellbahn)
Merkmal	Beschreibung
MaÃŸstab	H0 (1:87)
Farbgebung	DB-Rotbraun mit beigem Dach
Kupplung	NEM 362 mit Kurzkupplungskulisse
Hersteller (vermutlich)	Roco, Fleischmann, MÃ¤rklin oder Trix (alle bieten Varianten des Gms 54)
Artikelnummern (Beispiele)	Roco 4335, Fleischmann 5071, MÃ¤rklin 4411
Epoche (Modell)	III
Material	KunststoffgehÃ¤use, Metallachsen
Besonderheiten	PrÃ¤zise Beschriftung, fein gravierte TÃ¼ren, vorbildgerechtes Fahrwerk
ğŸ§¾ Kurzbeschreibung (fÃ¼r Homepage oder Sammlung)

DB Gedeckter GÃ¼terwagen Gms 54 â€“ Epoche III
Vorbildgerechtes Modell eines zweiachsigen gedeckten GÃ¼terwagens der Deutschen Bundesbahn in klassischer rotbrauner Lackierung mit beigem Dach.
Diese Wagenserie wurde ab Mitte der 1950er Jahre fÃ¼r den StÃ¼ckgutverkehr eingesetzt und war auf nahezu allen Strecken in Deutschland und Europa anzutreffen.
Das H0-Modell besticht durch feine Gravuren, exakte Beschriftung und authentische Farbgebung â€“ ein unverzichtbares Fahrzeug jeder DB-Sammlung der Nachkriegszeit.