Auf deinem Foto erkennt man die Beschriftung â€DB 39 046â€œ, was auf eine Dampflokomotive der Baureihe 39 der Deutschen Bundesbahn hinweist.
Diese Loks sind echte Klassiker aus der Ãœbergangszeit zwischen LÃ¤nderbahn- und Einheitsloks.

ğŸš‚ Vorbildinformationen
Merkmal	Beschreibung
Baureihe (Vorbild)	DB Baureihe 39 (preuÃŸische P 10)
Bauart	Schlepptenderlokomotive fÃ¼r Schnell- und PersonenzÃ¼ge
Hersteller (Vorbild)	Henschel, Schwartzkopff, Borsig, Hanomag, Maffei u. a.
Baujahre (Vorbild)	1922 â€“ 1927
Achsanordnung	2â€™C1â€™ (hat also 4 Kuppelachsen mit Laufachsen vorne und hinten)
Leistung	ca. 1 620 PS
HÃ¶chstgeschwindigkeit	110 km/h
Einsatzgebiet	SchnellzÃ¼ge und schwere PersonenzÃ¼ge auf Mittelgebirgs- und Hauptstrecken
Bahngesellschaft	Deutsche Reichsbahn â†’ ab 1949 Deutsche Bundesbahn
Epoche	III (1949 â€“ 1970)
Lackierung	Schwarz mit rotem Fahrgestell (klassische DB-Dampflokfarbgebung)

Die BR 39 war die leistungsstÃ¤rkste preuÃŸische Personenzuglok und galt als robustes Arbeitstier fÃ¼r gebirgige Strecken. Sie wurde spÃ¤ter durch die BR 03 und 41 ersetzt.

ğŸ§© Zum Modell (Modellbahn)

Typische Merkmale:

Kategorie	Beschreibung
MaÃŸstab	H0 (1:87)
Bauart	KunststoffgehÃ¤use, fein detailliert, Kuppelradsatz mit GestÃ¤nge
Antrieb	Motor im Tender mit Kardan auf die Lokachsen oder Direktantrieb
Hersteller (vermutlich)	Roco (feine Detaillierung), Fleischmann (klassische DB 39), oder MÃ¤rklin (MetallgehÃ¤use, AC-Betrieb)
Epoche (Modell)	III â€“ DB-Zeit mit altem DB-Keks
Farbschema	Schwarz/Rot, vorbildgerecht gemÃ¤ÃŸ DB-Standard